{
  "name": "stem_ep",
  "default": 0,
  "map": {
    "HA1": {
      "21": 1,
      "38": 1,
      "40": 1,
      "41": 1,
      "42": 1,
      "291": 1,
      "292": 1,
      "293": 1,
      "318": 1,
      "325": 1,
      "326": 1
    },
    "HA2": {
      "15": 1,
      "16": 1,
      "18": 1,
      "19": 1,
      "20": 1,
      "21": 1,
      "30": 1,
      "32": 1,
      "33": 1,
      "34": 1,
      "35": 1,
      "36": 1,
      "38": 1,
      "41": 1,
      "42": 1,
      "45": 1,
      "46": 1,
      "48": 1,
      "49": 1,
      "52": 1,
      "56": 1,
      "146": 1,
      "150": 1
    }
  }
}