{
    "name": "krammer",
    "default": 0,
    "map": {
        "NA": {
            "147": 1,
            "150": 1,
            "152": 1,
            "153": 1,
            "154": 1,
            "155": 1,
            "197": 1,
            "198": 1,
            "199": 1,
            "218": 1,
            "219": 1,
            "220": 1,
            "221": 1,
            "222": 1,
            "224": 1,
            "245": 1,
            "246": 1,
            "247": 1,
            "248": 1,
            "249": 1,
            "251": 1,
            "253": 1,
            "328": 1,
            "329": 1,
            "330": 1,
            "331": 1,
            "332": 1,
            "333": 1,
            "334": 1,
            "335": 1,
            "336": 1,
            "339": 1,
            "340": 1,
            "341": 1,
            "342": 1,
            "343": 1,
            "344": 1,
            "345": 1,
            "346": 1,
            "347": 1,
            "367": 1,
            "368": 1,
            "369": 1,
            "370": 1,
            "400": 1,
            "401": 1,
            "402": 1,
            "403": 1,
            "429": 1,
            "431": 1,
            "432": 1,
            "433": 1,
            "434": 1
        }
    }
}
